##########
#........#
#........#
#..####..#
#..#..#..#
#.@#..#..#
#..####..#
#........#
#........#
##########