##########
#........#
#........#
#........#
#........#
####.@####
#........#
#........#
#........#
##########