##########
#.#....#.#
###....###
#........#
#........#
#....@...#
#........#
#........#
#........#
##########