##########
#@.......#
#........#
#..####..#
#..#..#..#
#..#..#..#
#..####..#
#........#
#........#
##########