##########
#.#....#.#
###....###
#........#
#........#
#........#
#........#
#........#
#@.......#
##########