##########
#@.......#
#........#
#........#
#........#
#........#
#........#
#........#
#........#
##########