##########
##......##
#.#....#.#
#........#
#........#
#....@...#
#........#
#.#....#.#
##......##
##########