###############
#@............#
#.............#
#.............#
#.............#
#.............#
#.............#
#.............#
#.............#
#.............#
#.....##......#
#.....##......#
#.....##......#
#.....##......#
###############