###############
#@............#
#.............#
#.............#
#.............#
#....#####....#
#....#####....#
#....#####....#
#....#####....#
#....#####....#
#.............#
#.............#
#.............#
#.............#
###############