###############
#@............#
#.............#
#.............#
#.............#
#.............#
#.............#
#.............#
#.............#
#.............#
#.............#
#.#.........#.#
#.##.......##.#
#.###########.#
###############