###############
#T-----------7#
#|@.....#....|#
#|..#......#.|#
#|...........|#
#|........#..|#
#|...........|#
#|....#......|#
#|...........|#
#|.#..#..#...|#
#|...........|#
#|.#....#....|#
#|.........#.|#
#L-----------J#
###############