###############
#@...........##
#...........#.#
#..........#..#
#.........#...#
#.............#
#.............#
#.............#
#.............#
#.............#
#...#.........#
#..#..........#
#.#...........#
##............#
###############